12
██████████
█i█     ██
█   ███  █
████████ █
█        █
█ ██████ █
█      █ █
████ █ █ █
████ █ █ █
█    █ █ █
█f████████
██████████