12
██████████
█ █     ██
█   ███  █
████████ █
█        █
█ ██████ █
█  i   █ █
████ █ █ █
████ █ █ █
█    █ █ █
█f████████
██████████