11
█i████████
█ █     ██
█   ███  █
████████ █
█        █
█ ██████ █
█      █ █
████ █ █ █
████ █ █ █
█    █ █ █
█f████████
