12
██████████
█i█     ██
█   ███  █
████████ █
█        █ █  █
█ ██████ █
█      █ █ █  █
████ █ █ █ ████
████ █ █ █
█    █ █ █
█f████████
██████████