12
██████████
█i█     ██
█   ███  █
████████ █
█       t█ █  █
█ ██████ █
█   j  █ █ █  █
████ █ █ █ ████
████ █ █ █
█    █r█r█
█f████████
██████████