8
███████████
█   █    i█
███   █████
███████████
███████████
███████████
███f███████
███████████