██████████
█   █    i
█ █   ████
██████████
██████████
██████████
██████████
██████████
██████████
██████████